111111111111111111111111111
100100000C00000000000000001
111101100000000000000010001
1C0001010001010101001010001
111001001001010001001010011
100C01P0E001010101111110011
101000000000000000000010111
111111111111111111111111111