11111111111111111111111
1PC10000000000000000001
10C10110001101011101101
10010101000101010100101
1010C100100101010100101
100001000E0101010111111
10100000000000000000001
11111111111111111111111
