111111111111111111111111111
100100000C00000000000000001
11110110000000000C000010001
1C0001010001010101001010001
111001001001010001001010011
100001000001010101111110011
101000000C0000000E00P010111
111111111111111111111111111